[Overcast Network]
https://oc.tc/Heylatsch - Hack: Fly

[Hacks list]
Aimbot: エイム自動補正
Autoarmor: 防具自動装備
AntiKnockback/Noknockback: ノックバック無効
Autotool: ブロック破壊時自動で適切ツール使用
Bowaimbot: 弓エイム自動補正
Blink: TP
Criticals: 全攻撃をクリティカルにする
Clickaimbot: クリック時自動エイム補正
Clickbot: 高速連打
Dolphin: 速く泳ぐ
Fastfall: 落下速度上昇
Fly: 飛行
Forcefield: 周囲のプレイヤーにダメージ付与
Fastbreak: 高速ブロック破壊
Fasteat: 速く食べる(消費有)
Fastplace: 高速ブロック設置
Fastheal: 食事音異常 即時回復
Fastbow/Instantbow: 弓高速連射
Fastconsume: 食事音異常(消費無)
Fastladder: はしごを速くのぼる
Glide: 落下速度低下
Highjump: 跳躍力上昇
Jesus/Waterwalk: 水上歩行
Killaura: キル無双
Nuker: 周囲のブロック削除
Nofall: 落下ダメージ無効
Noslowdown: 走りながら弓射ち・食事 水やクモの巣でも動きが遅くならない
Noburn: 燃えても一瞬で消える
Speed: 移動速度上昇
Spider/Climb: 壁のぼり
Sneak: スニーク状態維持
Step: 段差を速くのぼる
Timer: 全てのアクションをn倍速
Xray: 地下透視
